WWWWWWWWWWWWWWW
WFWFFFFFWWFFGUW
WFFFWWWFWWFWFWW
WFWFWWFFWFFFFFW
WFWFWFFFFFWWWFW
WFWWWFWFWFFWWFW
IFFWFFWFWWFFFFW
IWFFFWWWWWFWWWW
IWFWWWFFWFFFFFW
WFFFFFFFWFWWWFW
WFWFWWWFWFWFFFW
WFFFFFWWWWWFWWW
WFWWWFWFWFWFFFW
WFADWFFFWFFFWFW
WWWWWWWWWWWWWWW