WWWWWWWWWWWWWWW
WFWFFFFFWWFFGUW
WFFFWWWFWWFWFWW
WFWFWWFFWFFFFFW
WFWFWFFFFFWWWFW
WFWWWFWFWFFWWFW
WFFWFFWFWWFFFFW
WWFFFWWWWWFWWWW
WWFWWWFFWFFFFFW
WFFFFFFFWFWWWFW
WFWFWWWFWFWFFFW
WFFFFFWWWWWFWWW
WFWWWFWFWFWFFFW
WFADWFFFWFFFWFW
WWWWWWWWWWWWWWW