WWWWWWWWWWWWWWW
WFWFFFFFWWFFGSW
WFFFWWWFWWFWFWW
WFWFWWFFWFFFFFW
WFWFWFFFFFWWWFW
WFWWWFWFWFFWWFW
WFFWFFWFWWFFFFW
WWFFFWWWWWFWWWW
WWFWWWFFWFFFFFW
WFFFFFFFWFWWWFW
WFWFWWWFWFWFFFW
WFFFFFWWWWWFWWW
WFWWWFWFWFWFFFW
WFAEWFFFWFFFWFW
WWWWWWWWWWWWWWW